 ╔═════════════════╗ 
 ║........║........║ 
 ║.══.═══.║.═══.══.║ 
 ║.................║ 
 ║.══.║.═════.║....║ 
 ║....║...║...║....║ 
 ╚══╗.║══.║.══║.╔══╝ 
    ║.║.......║.║    
════╝.║.╔═ ═╗.║.╚════
     ...║   ║...     
════╗.║.╚═══╝.║.╔════
    ║.║.......║.║    
 ╔══╝.║ ═════ ║.╚══╗ 
 ║........║........║ 
 ║.═╗.═══.║.═══.╔═.║ 
 ║..║...........║..║ 
 ║═.║...═════...║..║ 
 ║....║...║...║....║ 
 ║.══════.║.══════.║ 
 ║.................║ 
 ╚═════════════════╝ 