 ╔════════╦════════╗ 
 ║........║........║ 
 ║.══.═══.║.═══.══.║ 
 ║..●...........●..║ 
 ║.══.║.══╦══.║.══.║ 
 ║....║...║...║....║ 
 ╚══╗.╠══.║.══╣.╔══╝ 
    ║.║.......║.║    
════╝.║.╔═ ═╗.║.╚════
     ...║   ║...     
════╗.║.╚═══╝.║.╔════
    ║.║.......║.║    
 ╔══╝.║.══╦══.║.╚══╗ 
 ║........║........║ 
 ║.═╗.═══.║.═══.╔═.║ 
 ║..║.....●.....║..║ 
 ╠═.║...═════...║.═╣ 
 ║..●.║...║...║.●..║ 
 ║.══════.║.══════.║ 
 ║.................║ 
 ╚═════════════════╝ 
