 ╔════════╦════════╗ 
 ║........║........║ 
 ║.══.═══.║.═══.══.║ 
 ║.................║ 
 ║.══.║.══╦══.║.══.║ 
 ║....║...║...║....║ 
 ╚══╗.╠══.║.══╣.╔══╝ 
    ║.║.......║.║    
════╝.║.╔═ ═╗.║.╚════
     ...║   ║...     
════╗.║.╚═══╝.║.╔════
    ║.║.......║.║    
 ╔══╝.║.══╦══.║.╚══╗ 
 ║........║........║ 
 ║.═╗.═══.║.═══.╔═.║ 
 ║..║...........║..║ 
 ╠═.║...══╦══...║.═╣ 
 ║....║...║...║....║ 
 ║.══════.║.══════.║ 
 ║.................║ 
 ╚═════════════════╝ 
