╔═════════════════════╗
       ║.......║       
╔═════.║.║.║.║.║.═════╗
║........║...║........║
║.╔═════.╚═══╝.═════╗.║
║.║.....       .....║.║
║.║.═══╗ ╔═ ═╗ ╔═══.║.║
║......║ ║   ║ ║......║
║═════.║ ╚═══╝ ║.═════║
║.......       .......║
║.═══╗.║..╔═╗..║.╔═══.║
║....║.╚═.║ ║.═╝.║....║
╚══╗......║ ║......╔══╝
═══╝.════.╚═╝.════.╚═══
    ...║.......║...    
╔═══.║.║.═════.║.║.═══╗
║....║.....║.....║....║
║.═══╝.═══.║.═══.╚═══.║
║.....................║
╚═════════════════════╝
