╔══════╦═══════╦══════╗
       ║.......║       
╔═════.║.║.║.║.║.═════╗
║........║...║........║
║.╔═════.╚═══╝.═════╗.║
║.║.....       .....║.║
║.║.═══╗ ╔═ ═╗ ╔═══.║.║
║.●....║ ║   ║ ║....●.║
╠═════.║ ╚═══╝ ║.═════╣
║.......       .......║
║.═══╗.║..╔═╗..║.╔═══.║
║....║.╚═.║ ║.═╝.║....║
╚══╗......║ ║......╔══╝
═══╝.══╦═.╚═╝.═╦══.╚═══
    ...║...●...║...    
╔═══.║.║.══╦══.║.║.═══╗
║....║.....║.....║....║
║.═══╝.═══.║.═══.╚═══.║
║..●...............●..║
╚═════════════════════╝
