╔════════.════════╗
║.................║
║.╔══╗.╔═══╗.╔══╗.║
║.║  ║.║   ║.║  ║.║
║.╚══╝.╚═══╝.╚══╝.║
║.................║
║.══.╗.╔═ ═╗.╔═══.║
.....║.║   ║.║.....
║.═══╝.╚═══╝.╚.══.║
║.................║
║.╔══╗.╔═══╗.╔══╗.║
║.║  ║.║   ║.║  ║.║
║.╚══╝.╚═══╝.╚══╝.║
║.................║
╚════════.════════╝
