StringMatrix kmap
{{"╔","═","═","═","═","═","═","╦","═","═","═"," ","═","═","═","╦","═","═","═","═","═","═","╗",}
{" "," "," "," "," "," "," ","║",".",".",".",".",".",".",".","║"," "," "," "," "," "," "," ",}
{"╔","═","═","═","═","═",".","║",".","║",".","║",".","║",".","║",".","═","═","═","═","═","╗",}
{"║",".",".",".",".",".",".",".",".","║",".",".",".","║",".",".",".",".",".",".",".",".","║",}
{"║",".","╔","═","═","═","═","═",".","╚","═","═","═","╝",".","═","═","═","═","═","╗",".","║",}
{"║",".","║",".",".",".",".","."," "," "," "," "," "," "," ",".",".",".",".",".","║",".","║",}
{"║",".","║",".","═","═","═","╗"," ","╔","═"," ","═","╗"," ","╔","═","═","═",".","║",".","║",}
{"║",".","●",".",".",".",".","║"," ","║","@","£","$","║"," ","║",".",".",".",".","●",".","║",}
{"╠","═","═","═","═","═",".","║"," ","╚","═","═","═","╝"," ","║",".","═","═","═","═","═","╣",}
{"║",".",".",".",".",".",".","."," "," "," "," "," "," "," ",".",".",".",".",".",".",".","║",}
{"║",".","═","═","═","╗",".","║",".",".","╔","═","╗",".",".","║",".","╔","═","═","═",".","║",}
{"║",".",".",".",".","║",".","╚","═",".","║"," ","║",".","═","╝",".","║",".",".",".",".","║",}
{"╚","═","═","╗",".",".",".",".",".",".","║"," ","║",".",".",".",".",".",".","╔","═","═","╝",}
{" "," "," ","║",".","═","═","╦","═",".","╚","═","╝",".","═","╦","═","═",".","║"," "," "," ",}
{" "," "," ","║",".",".",".","║",".",".",".","●",".",".",".","║",".",".",".","║"," "," "," ",}
{"╔","═","═","╝",".","║",".","║",".","═","═","╦","═","═",".","║",".","║",".","╚","═","═","╗",}
{"║",".",".",".",".","║",".",".",".",".",".","║",".",".",".",".",".","║",".",".",".",".","║",}
{"║",".","═","═","═","╝",".","═","═","═",".","║",".","═","═","═",".","╚","═","═","═",".","║",}
{"║",".",".","●",".",".",".",".",".",".",".",".",".",".",".",".",".",".",".","●",".",".","║",}
{"╚","═","═","═","═","═","═","═","═","═","═"," ","═","═","═","═","═","═","═","═","═","═","╝",}};
