"╔","═","═","═","═","═","═","╦","═","═","═","═","═","═","═","╦","═","═","═","═","═","═","╗",
" "," "," "," "," "," "," ","║",".",".",".",".",".",".",".","║"," "," "," "," "," "," "," ",
"╔","═","═","═","═","═",".","║",".","║",".","║",".","║",".","║",".","═","═","═","═","═","╗",
"║",".",".",".",".",".",".",".",".","║",".",".",".","║",".",".",".",".",".",".",".",".","║",
"║",".","╔","═","═","═","═","═",".","╚","═","═","═","╝",".","═","═","═","═","═","╗",".","║",
"║",".","║",".",".",".",".","."," "," "," "," "," "," "," ",".",".",".",".",".","║",".","║",
"║",".","║",".","═","═","═","╗"," ","╔","═"," ","═","╗"," ","╔","═","═","═",".","║",".","║",
"║",".","●",".",".",".",".","║"," ","║","@","£","$","║"," ","║",".",".",".",".","●",".","║",
"╠","═","═","═","═","═",".","║"," ","╚","═","═","═","╝"," ","║",".","═","═","═","═","═","╣",
"║",".",".",".",".",".",".","."," "," "," "," "," "," "," ",".",".",".",".",".",".",".","║",
"║",".","═","═","═","╗",".","║",".",".","╔","═","╗",".",".","║",".","╔","═","═","═",".","║",
"║",".",".",".",".","║",".","╚","═",".","║"," ","║",".","═","╝",".","║",".",".",".",".","║",
"╚","═","═","╗",".",".",".",".",".",".","║"," ","║",".",".",".",".",".",".","╔","═","═","╝",
"═","═","═","╝",".","═","═","╦","═",".","╚","═","╝",".","═","╦","═","═",".","╚","═","═","═",
" "," "," "," ",".",".",".","║",".",".",".","●",".",".",".","║",".",".","."," "," "," "," ",
"╔","═","═","═",".","║",".","║",".","═","═","╦","═","═",".","║",".","║",".","═","═","═","╗",
"║",".",".",".",".","║",".",".",".",".",".","║",".",".",".",".",".","║",".",".",".",".","║",
"║",".","═","═","═","╝",".","═","═","═",".","║",".","═","═","═",".","╚","═","═","═",".","║",
"║",".",".","●",".",".",".",".",".",".",".",".",".",".",".",".",".",".",".","●",".",".","║",
"╚","═","═","═","═","═","═","═","═","═","═","═","═","═","═","═","═","═","═","═","═","═","╝",
