"╔","═","═","═","═","═","═","═","═",".","═","═","═","═","═","═","═","═","╗",
"║",".",".",".",".",".",".",".",".",".",".",".",".",".",".",".",".",".","║",
"║",".","╔","═","═","╗",".","╔","═","═","═","╗",".","╔","═","═","╗",".","║",
"║",".","║"," "," ","║",".","║"," "," "," ","║",".","║"," "," ","║",".","║",
"║",".","╚","═","═","╝","●","╚","═","═","═","╝","●","╚","═","═","╝",".","║",
"║",".",".",".",".",".",".",".",".",".",".",".",".",".",".",".",".",".","║",
"║",".","═","═","═","╗",".","╔","═"," ","═","╗",".","╔","═","═","═",".","║",
".",".",".",".",".","║",".","║","@","£","$","║",".","║",".",".",".",".",".",
"║",".",".",".",".","║",".","╚","═","═","═","╝",".","║",".",".",".",".","║",
"║",".",".",".",".",".",".",".",".",".",".",".",".",".",".",".",".",".","║",
"║",".","╔","═","═","╗",".","╔","═","═","═","╗",".","╔","═","═","╗",".","║",
"║",".","║"," "," ","║",".","║"," "," "," ","║",".","║"," "," ","║",".","║",
"║",".","╚","═","═","╝","●","╚","═","═","═","╝","●","╚","═","═","╝",".","║",
"║",".",".",".",".",".",".",".",".",".",".",".",".",".",".",".",".",".","║",
"╚","═","═","═","═","═","═","═","═",".","═","═","═","═","═","═","═","═","╝",
