╔═══════════════════╗
║...................║
║.║.═══.╔═══╗.═══.║.║
║.║.....║...║.....║.║
║.╚══.║.║.║.║.║.══╝.║
║.....║...║...║.....║
╚═╗.══╬══.║.══╬══.╔═╝
  ║...║.......║...║
══╝.║.║.╔═ ═╗.║.║.╚══
   .║...║   ║...║.
════╣.║.╚═══╝.║.╠════
   .║.║.......║.║..
══╗.║.╠═╗.║.╔═╣.║.╔══
  ║...╚═╝.║.╚═╝...║
╔═╝.║.....║.....║.╚═╗
║...╠══.║...║.══╣...║
║.╔═╝...╚═══╝...╚═╗.║
║.║...║.......║...║.║
║.║.══╩══.║.══╩══.║.║
║.........║.........║
╚═══════════════════╝
