StringMatrix kmap
{{"╔","═","═","═","═","═","═","═","═","═","═","═","═","═","═","═","═","═","═","═","╗",}
{"║",".",".",".",".",".",".",".",".",".",".",".",".",".",".",".",".",".",".",".","║",}
{"║",".","║",".","═","═","═",".","╔","═","═","═","╗",".","═","═","═",".","║",".","║",}
{"║",".","║",".",".",".","●",".","║",".",".",".","║",".","●",".",".",".","║",".","║",}
{"║",".","╚","═","═",".","║",".","║",".","║",".","║",".","║",".","═","═","╝",".","║",}
{"║",".",".",".",".",".","║",".",".",".","║",".",".",".","║",".",".",".",".",".","║",}
{"╚","═","╗",".","═","═",╩"═","═",".","║",".","═","═",╩"═","═",".","╔","═","╝",}
{" "," ","║",".",".",".","║",".",".",".",".",".",".",".","║",".",".",".","║"," "," ",}
{"═","═","╝",".","║",".","║",".","╔","═"," ","═","╗",".","║",".","║",".","╚","═","═",}
{" "," "," ",".","║",".",".",".","║","@","£","$","║",".",".",".","║","."," "," "," ",}
{"═","═","═","═","╣",".","║",".","╚","═","═","═","╝",".","║",".","╠","═","═","═","═",}
{" "," "," ",".","║",".","║",".",".",".",".",".",".",".","║",".","║",".","."," "," ",}
{"═","═","╗",".","║",".","╠","═","╗",".","║",".","╔","═","╣",".","║",".","╔","═","═",}
{" "," ","║",".",".",".","╚","═","╝",".","║",".","╚","═","╝",".",".",".","║"," "," ",}
{"╔","═","╝",".","║",".",".","●",".",".","║",".",".","●",".",".","║",".","╚","═","╗",}
{"║",".",".",".","╠","═","═",".","║",".",".",".","║",".","═","═","╣",".",".",".","║",}
{"║",".","╔","═","╝",".",".",".","╚","═","═","═","╝",".",".",".","╚","═","╗",".","║",}
{"║",".","║",".",".",".","║",".",".",".","●",".",".",".","║",".",".",".","║",".","║",}
{"║",".","║",".","═","═",╩"═","═",".","║",".","═","═",╩"═","═",".","║",".","║",}
{"║",".",".",".",".",".",".",".",".",".","║",".",".",".",".",".",".",".",".",".","║",}
{"╚","═","═","═","═","═","═","═","═","═","═","═","═","═","═","═","═","═","═","═","╝",}};
