StringMatrix kmap
{"╔","═","═","═","═","═","═","═","═",".","═","═","═","═","═","═","═","═","╗",}
{"║",".",".",".",".",".",".",".",".",".",".",".",".",".",".",".",".",".","║",}
{"║",".","╔","═","═","╗",".","╔","═","═","═","╗",".","╔","═","═","╗",".","║",}
{"║",".","║"," "," ","║",".","║"," "," "," ","║",".","║"," "," ","║",".","║",}
{"║",".","╚","═","═","╝","●","╚","═","═","═","╝","●","╚","═","═","╝",".","║",}
{"║",".",".",".",".",".",".",".",".",".",".",".",".",".",".",".",".",".","║",}
{"║",".","═","═","═","╗",".","╔","═"," ","═","╗",".","╔","═","═","═",".","║",}
{".",".",".",".",".","║",".","║","@","£","$","║",".","║",".",".",".",".",".",}
{"║",".",".",".",".","║",".","╚","═","═","═","╝",".","║",".",".",".",".","║",}
{"║",".",".",".",".",".",".",".",".",".",".",".",".",".",".",".",".",".","║",}
{"║",".","╔","═","═","╗",".","╔","═","═","═","╗",".","╔","═","═","╗",".","║",}
{"║",".","║"," "," ","║",".","║"," "," "," ","║",".","║"," "," ","║",".","║",}
{"║",".","╚","═","═","╝","●","╚","═","═","═","╝","●","╚","═","═","╝",".","║",}
{"║",".",".",".",".",".",".",".",".",".",".",".",".",".",".",".",".",".","║",}
{"╚","═","═","═","═","═","═","═","═",".","═","═","═","═","═","═","═","═","╝",}};
