╔═══════════════════╗
║...................║
║.║.═══.╔═══╗.═══.║.║
║.║...●.║...║.●...║.║
║.╚══.║.║.║.║.║.══╝.║
║.....║...║...║.....║
╚═╗.══╩══.║.══╩══.╔═╝
  ║...║.......║...║
══╝.║.║.╔═ ═╗.║.║.╚══
   .║...║   ║...║.
════╣.║.╚═══╝.║.╠════
   .║.║.......║.║..
══╗.║.╠═╗.║.╔═╣.║.╔══
  ║...╚═╝.║.╚═╝...║
╔═╝.║..●..║..●..║.╚═╗
║...╠══.║...║.══╣...║
║.╔═╝...╚═══╝...╚═╗.║
║.║...║...●...║...║.║
║.║.══╩══.║.══╩══.║.║
║.........║.........║
╚═══════════════════╝
