╔══════╦═══════╦══════╗
       ║.......║       
╔═════.║.║.║.║.║.═════╗
║........║...║........║
║.╔═════.╚═══╝.═════╗.║
║.║.....       .....║.║
║.║.═══╗ ╔═ ═╗ ╔═══.║.║
║......║ ║   ║ ║......║
╠═════.║ ╚═══╝ ║.═════╣
║.......       .......║
║.═══╗.║..╔═╗..║.╔═══.║
║....║.╚═.║ ║.═╝.║....║
╚══╗......║ ║......╔══╝
═══╝.══╦═.╚═╝.═╦══.╚═══
    ...║.......║...    
╔═══.║.║.══╦══.║.║.═══╗
║....║.....║.....║....║
║.═══╝.═══.║.═══.╚═══.║
║.....................║
╚═════════════════════╝
