    ╔══╦═══╝ ╚═══╦══╗
  ╔═╝..║.........║..╚═╗
 ╔╝.......══╦══.......╚╗
 ║..╔══╗═...║...═╔══╗..║
 ║..╠╗ ║..══╩══..╠╗ ║..║
╔╝..╚╩═╝.........╚╩═╝..╚╗
║ ║...║...╔═ ═╗...║...║ ║
║ ╠══...║.║   ║.║...══╣ ║
║ ║....═╝.╚═╦═╝.╚═....║ ║
╚═╩═══......║.......══╩═╝
     ...══.....══...     
╔══╦═══╗  ╔╗ ╔╗  ╔═══╦══╗
║ ╔╝   ╚╗╔╝║ ║╚╗╔╝   ╚╗ ║
╚═╝     ╚╝ ║ ║ ╚╝     ╚═╝
