"╔","═","═","═","═","═","═","═","═","═","═","═","═","═","═","═","═","═","═","═","╗",
"║",".",".",".",".",".",".",".",".",".",".",".",".",".",".",".",".",".",".",".","║",
"║",".","║",".","═","═","═",".","╔","═","═","═","╗",".","═","═","═",".","║",".","║",
"║",".","║",".",".",".","●",".","║",".",".",".","║",".","●",".",".",".","║",".","║",
"║",".","╚","═","═",".","║",".","║",".","║",".","║",".","║",".","═","═","╝",".","║",
"║",".",".",".",".",".","║",".",".",".","║",".",".",".","║",".",".",".",".",".","║",
"╚","═","╗",".","═","═",╩"═","═",".","║",".","═","═",╩"═","═",".","╔","═","╝",
" "," ","║",".",".",".","║",".",".",".",".",".",".",".","║",".",".",".","║"," "," ",
"═","═","╝",".","║",".","║",".","╔","═"," ","═","╗",".","║",".","║",".","╚","═","═",
" "," "," ",".","║",".",".",".","║","@","£","$","║",".",".",".","║","."," "," "," ",
"═","═","═","═","╣",".","║",".","╚","═","═","═","╝",".","║",".","╠","═","═","═","═",
" "," "," ",".","║",".","║",".",".",".",".",".",".",".","║",".","║",".","."," "," ",
"═","═","╗",".","║",".","╠","═","╗",".","║",".","╔","═","╣",".","║",".","╔","═","═",
" "," ","║",".",".",".","╚","═","╝",".","║",".","╚","═","╝",".",".",".","║"," "," ",
"╔","═","╝",".","║",".",".","●",".",".","║",".",".","●",".",".","║",".","╚","═","╗",
"║",".",".",".","╠","═","═",".","║",".",".",".","║",".","═","═","╣",".",".",".","║",
"║",".","╔","═","╝",".",".",".","╚","═","═","═","╝",".",".",".","╚","═","╗",".","║",
"║",".","║",".",".",".","║",".",".",".","●",".",".",".","║",".",".",".","║",".","║",
"║",".","║",".","═","═",╩"═","═",".","║",".","═","═",╩"═","═",".","║",".","║",
"║",".",".",".",".",".",".",".",".",".","║",".",".",".",".",".",".",".",".",".","║",
"╚","═","═","═","═","═","═","═","═","═","═","═","═","═","═","═","═","═","═","═","╝",
