kmap
{{"╔","═","═","═","═","═","═","═","═","╦","═","═","═","═","═","═","═","═","╗"}
{"║",".",".",".",".",".",".",".",".","║",".",".",".",".",".",".",".",".","║"}
{"║",".","═","═",".","═","═","═",".","║",".","═","═","═",".","═","═",".","║"}
{"║",".",".","●",".",".",".",".",".",".",".",".",".",".",".","●",".",".","║"}
{"║",".","═","═",".","║",".","═","═","╦","═","═",".","║",".","═","═",".","║"}
{"║",".",".",".",".","║",".",".",".","║",".",".",".","║",".",".",".",".","║"}
{"╚","═","═","╗",".","╠","═","═",".","║",".","═","═","╣",".","╔","═","═","╝"}
{" "," "," ","║",".","║",".",".",".",".",".",".",".","║",".","║"," "," "," "}
{"═","═","═","╝",".","║",".","╔","═"," ","═","╗",".","║",".","╚","═","═","═"}
{" "," "," "," ",".",".",".","║"," "," "," ","║",".",".","."," "," "," "," "}
{"═","═","═","╗",".","║",".","╚","═","═","═","╝",".","║",".","╔","═","═","═"}
{" "," "," ","║",".","║",".",".",".",".",".",".",".","║",".","║"," "," "," "}
{"╔","═","═","╝",".","║",".","═","═","╦","═","═",".","║",".","╚","═","═","╗"}
{"║",".",".",".",".",".",".",".",".","║",".",".",".",".",".",".",".",".","║"}
{"║",".","═","╗",".","═","═","═",".","║",".","═","═","═",".","╔","═",".","║"}
{"║",".",".","║",".",".",".",".",".","●",".",".",".",".",".","║",".",".","║"}
{"╠","═",".","║",".",".",".","═","═","═","═","═",".",".",".","║",".","═","╣"}
{"║",".",".","●",".","║",".",".",".","║",".",".",".","║",".","●",".",".","║"}
{"║",".","═","═","═","═","═","═",".","║",".","═","═","═","═","═","═",".","║"}
{"║",".",".",".",".",".",".",".",".",".",".",".",".",".",".",".",".",".","║"}
{"╚","═","═","═","═","═","═","═","═","═","═","═","═","═","═","═","═","═","╝"}}
