╔════════.════════╗
║.................║
║.╔══╗.╔═══╗.╔══╗.║
║.║  ║.║   ║.║  ║.║
║.╚══╝●╚═══╝●╚══╝.║
║.................║
║.═══╗.╔═ ═╗.╔═══.║
.....║.║   ║.║.....
║....║.╚═══╝.║....║
║.................║
║.╔══╗.╔═══╗.╔══╗.║
║.║  ║.║   ║.║  ║.║
║.╚══╝●╚═══╝●╚══╝.║
║.................║
╚════════.════════╝
