╔══════╦═══════╦══════╗
       ║.......║       
╔═════.║.║.║.║.║.═════╗
║........║.¤.║........║
║.╔═════.╚═══╝.═════╗.║
║.║.....       .....║.║
║.║.═══╗ ╔═ ═╗ ╔═══.║.║
║.●....║ ║   ║ ║....●.║
╠═════.║ ╚═══╝ ║.═════╣
║.......       .......║
║.═══╗.║..╔═╗..║.╔═══.║
║....║.╚═.║ ║.═╝.║....║
╚══╗......║ ║......╔══╝
═══╝.══╦═.╚═╝.═╦══.╚═══
    ...║...¤...║...    
╔═══.║.║.══╦══.║.║.═══╗
║....║.....║.....║....║
║.═══╝.═══.║.═══.╚═══.║
║..●...............●..║
╚═════════════════════╝
