 ╔═════════════════╗ 
 ║........║........║ 
 ║.══.═══.║.═══.══.║ 
 ║.................║ 
 ║.══.║.═════.║....║ 
 ║....║...║...║....║ 
 ╚══╗.║══.║.══║.╔══╝ 
    ║.║.......║.║    
════╝.║.╔═ ═╗.║.╚════
     ...║   ║...     
════╗.║.╚═══╝.║.╔════
    ║.║.......║.║    
 ╔══╝.║ ═════ ║.╚══╗ 
 ║........║........║ 
 ║.═╗.═══.║.═══.╔═.║ 
 ║..║...........║..║ 
 ║═.║...═════...║..║ 
 ║....║...║...║....║ 
 ║.══════.║.══════.║ 
 ║.................║ 
 ╚═════════════════╝ 

    ╔══════.══════╗ 
    ║.............║
    ║.╔═.═╗.╔═.═╗.║
    ║.║...║.║...║.║
    ║.║.║.║.║.║.║.║
    ║.║.║.║.║.║.║.║
    ║.║...║.║...║.║
    ║.╚═.═╝.╚═.═╝.║
    ║.............║
    ║.╔═.═╗.╔═.═╗.║
    ║.║...║.║...║.║
    ║.║.║.║.║.║.║.║
    ║.║.║.║.║.║.║.║
    ║.║...║.║...║.║
    ║.╚═.═╝.╚═.═╝.║
    ║.............║
    ╚══════.══════╝

  ╔════════.════════╗
  ║.................║
  ║.╔══╗.╔═══╗.╔══╗.║
  ║.║  ║.║   ║.║  ║.║
  ║.╚══╝.╚═══╝.╚══╝.║
  ║.................║
  ║.═══╗.╔═ ═╗.╔═══.║
  .....║.║   ║.║.....
  ║....║.╚═══╝.║....║
  ║.................║
  ║.╔══╗.╔═══╗.╔══╗.║
  ║.║  ║.║   ║.║  ║.║
  ║.╚══╝.╚═══╝.╚══╝.║
  ║.................║
  ╚════════.════════╝
