╔══════.══════╗ 
║.............║
║.╔═.═╗.╔═.═╗.║
║.║...║.║...║.║
║.║.║.║.║.║.║.║
║.║.║.║.║.║.║.║
║.║...║.║...║.║
║.╚═.═╝.╚═.═╝.║
║.............║
║.╔═.═╗.╔═.═╗.║
║.║...║.║...║.║
║.║.║.║.║.║.║.║
║.║.║.║.║.║.║.║
║.║...║.║...║.║
║.╚═.═╝.╚═.═╝.║
║.............║
╚══════.══════╝
