╔═══════════════════╗
║...................║
║.║.═══.╔═══╗.═══.║.║
║.║.....║...║.....║.║
║.╚══.║.║.║.║.║.══╝.║
║.....║...║...║.....║
╚═╗.═════.║.═════.╔═╝
  ║...║.......║...║
══╝.║.║.╔═ ═╗.║.║.╚══
   .║...║   ║...║.
════║.║.╚═══╝.║.║════
   .║.║.......║.║..
══╗.║.║═╗.║.╔═║.║.╔══
  ║...╚═╝.║.╚═╝...║
╔═╝.║.....║.....║.╚═╗
║...║══.║...║.══║...║
║.╔═╝...╚═══╝...╚═╗.║
║.║...║.......║...║.║
║.║.═════.║.═════.║.║
║.........║.........║
╚═══════════════════╝
