StringMatrix kmap
{{"╔","═","═","═","═","═","═","═","═","╦","═","═","═","═","═","═","═","═","╗"}
{"║",".",".",".",".",".",".",".",".","║",".",".",".",".",".",".",".",".","║"}
{"║",".","═","═",".","═","═","═",".","║",".","═","═","═",".","═","═",".","║"}
{"║",".",".","●",".",".",".",".",".","¤",".",".",".",".",".","●",".",".","║"}
{"║",".","═","═",".","║",".","═","═","╦","═","═",".","║",".","═","═",".","║"}
{"║",".",".",".",".","║",".",".",".","║",".",".",".","║",".",".",".",".","║"}
{"╚","═","═","╗",".","╠","═","═",".","║",".","═","═","╣",".","╔","═","═","╝"}
{" "," "," ","║",".","║",".","@",".","£",".","$",".","║",".","║"," "," "," "}
{" "," "," ","║",".","║",".","╔","═"," ","═","╗",".","║",".","║"," "," "," "}
{" "," "," ","║",".",".",".","║"," "," "," ","║",".",".",".","║"," "," "," "}
{" "," "," ","║",".","║",".","╚","═","═","═","╝",".","║",".","║"," "," "," "}
{" "," "," ","║",".","║",".",".",".","ᗧ",".",".",".","║",".","║"," "," "," "}
{"╔","═","═","╝",".","║",".","═","═","╦","═","═",".","║",".","╚","═","═","╗"}
{"║",".",".",".",".",".",".",".",".","║",".",".",".",".",".",".",".",".","║"}
{"║",".","═","╗",".","═","═","═",".","║",".","═","═","═",".","╔","═",".","║"}
{"║",".",".","║",".",".",".",".",".","¤",".",".",".",".",".","║",".",".","║"}
{"╠","═",".","║",".",".",".","═","═","═","═","═",".",".",".","║",".","═","╣"}
{"║",".",".","●",".","║",".",".",".","║",".",".",".","║",".","●",".",".","║"}
{"║",".","═","═","═","═","═","═",".","║",".","═","═","═","═","═","═",".","║"}
{"║",".",".",".",".",".",".",".",".",".",".",".",".",".",".",".",".",".","║"}
{"╚","═","═","═","═","═","═","═","═","═","═","═","═","═","═","═","═","═","╝"}};
