StringMatrix kmap
{"╔","═","═","═","═","═","═","╦","═","═","═","═","═","═","═","╦","═","═","═","═","═","═","╗"},
    {".",".",".",".",".",".",".","║",".",".",".",".",".",".",".","║",".",".",".",".",".",".","."},
    {"╔",".","═","═","═","═",".","║",".","║",".","║",".","║",".","║",".","═","═","═","═",".","╗"},
    {"║",".",".",".",".",".",".",".",".","║",".",".",".","║",".",".",".",".",".",".",".",".","║"},
    {"║",".","╔","═","═","═","═","═",".","╚","═","═","═","╝",".","═","═","═","═","═","╗",".","║"},
    {"║",".","║",".",".",".",".",".",".",".",".",".",".",".",".",".",".",".",".",".","║",".","║"},
    {"║",".","║",".","═","═","═","╗",".","╔","═","═","═","╗",".","╔","═","═","═",".","║",".","║"},
    {"║",".","●",".",".",".",".","║",".","║","@","£","$","║",".","║",".",".",".",".","●",".","║"},
    {"╠","═","═","═","═","═",".","║",".","╚","═","═","═","╝",".","║",".","═","═","═","═","═","╣"},
    {"║",".",".",".",".",".",".",".",".",".",".",".",".",".",".",".",".",".",".",".",".",".","║"},
    {"║",".","═","═","═","╗",".","║",".",".","╔","═","╗",".",".","║",".","╔","═","═","═",".","║"},
    {"║",".",".",".",".","║",".","╚","═",".","║",".","║",".","═","╝",".","║",".",".",".",".","║"},
    {"╚","═","═","╗",".",".",".",".",".",".","║",".","║",".",".",".",".",".",".","╔","═","═","╝"},
    {"═","═","═","╝",".","═","═","╦","═",".","╚","═","╝",".","═","╦","═","═",".","╚","═","═","═"},
    {".",".",".",".",".",".",".","║",".",".",".","●",".",".",".","║",".",".",".",".",".",".","."},
    {"╔",".","═","═",".","║",".","║",".","═","═","╦","═","═",".","║",".","║",".","═","═",".","╗"},
    {"║",".",".",".",".","║",".",".",".",".",".","║",".",".",".",".",".","║",".",".",".",".","║"},
    {"║",".","═","═","═","╝",".","═","═","═",".","║",".","═","═","═",".","╚","═","═","═",".","║"},
    {"║",".",".","●",".",".",".",".",".",".",".",".",".",".",".",".",".",".",".","●",".",".","║"},
    {"╚","═","═","═","═","═","═","═","═","═","═","═","═","═","═","═","═","═","═","═","═","═","╝"}}; 
